EEEEFFFF
FEEEESEE
FEXXEEFE
EEXXEEEF
EEXXEEFF
FEEEEEEE
FESEFSFE
EFEFEFFE