EEEE29B94EEEEEEEEEEEEEEEEEEEEEEE
XXXX29B9733333333333333333333333
XXXX29BS999999999999999999999999
XXXX29BAAAAAAAAAAAAAAAAAAAAAAAAA
XXXX29B999999S9999999B999S999999
XXXX2SB95111111111169B9511111111
333389B94XXXXX42XXX29B94XXXEEXXX
9S9999B94XXXXX42XXX29B94XXXEEXXX
AAAAAAB94XXXXX42XXX29B94XXXEEXXX
99999SB94XXXXX42XXX29B94XXXEEXXX
111169B94XXXXX42XXX29B94XXXEEXXX
XXXX29B94XXXXX42XXX29B94XXXEEXXX
XXXX29B97333333333389B9733333333
XXXX29BS9999999999999B9999999999
XXXX29BAAAAAAAAAAAAAAAAAAAAAAAAA
XXXX29B999999S99999999999S999999
XXXX2SB95111111111169B9511111111
333389B94XXXXXXXXXX29B94XXXXXXXX
9S9999B94XXXXXXXXXX29B94EEEEXXXX
AAAAAAB94111111111129B94EEEEXXXX
99999SB94333333333329B94EEEEXXXX
111169B94XXXXXXXXXX29B94EEEEXXXX
XXXX29B94XXXXXXXXXX29B94XXXXXXXX
XXXX29B97333333333389B9733333333
XXXX29BS9999999999999B9999999999
XXXX29BAAAAAAAAAAAAAAAAAAAAAAAAA
XXXX29B999999S99999999999S999999
XXXX2SB9511111111111111111111111
XXXX29B94EEEEEEEEEEEEEEEEEEEEEXX
XXXX29B94EEXXEEEXXXEEEXXEEEEEXXX
XXXX29B94EEXXEEEXXXEEEXXEEEEXXXX
XXXX29B94EEEEEEEEEEEEEEEEEEXXXXX




