EEEEFFFF
FEEEEEEE
FEXXXEFE
EEXXXEEF
EEXXXEFF
FEEEEEEE
FEFEFEFE
EFEFEFEF