XXXX29B94XXXXXXXXXXXXXXXXXXXXXXX
XXXX29B9733333333333333333333333
XXXX299S999999S99999999999999999
XXXX2999AAAAAAAAAAAA999AAAAAAAAA
XXXX299999999S99999999999S999999
XXXX2SB95111111111169B9511111111
333389B94XXXXX42XXX29B94XXXEEXXX
9S9999994XXXXX42XXX29B94XXXEEXXX
AAAAA9994XXXXX42XXX29B94XXXEEXXX
99999S994XXXXX42XXX29B94XXXEEXXX
111169B94XXXXX42XXX29B94XXXEEXXX
XXXX29B94XXXXX42XXX29B94XXXEEXXX
XXXX29B97333333333389B9733333333
XXXX299S9999999S9999999999999999
XXXX2999AAAAAAAAAAAA999AAAAAAAAA
XXXX299999999S99999999999S9S9999
XXXX2SB95111111111169B9511111111
333389B94XXXXXXXXXX29B94XXXXXXXX
9S9999994XXXXXXXXXX29B94EEEEXXXX
AAAAA9994111111111129B94EEEEXXXX
99999S994333333333329B94EEEEXXXX
111169B94XXXXXXXXXX29B94EEEEXXXX
XXXX29B94XXXXXXXXXX29B94XXXXXXXX
XXXX29B97333333333389B9733333333
XXXX299S9999999999999999999S9999
XXXX2999AAAAAAAAAAAA999AAAAAAAAA
XXXX299999999S99999999999S999999
XXXX2SB9511111111111111111111111
XXXX29B94XXXXXXXXXXXXXXXXXXXXXXX
XXXX2SB94XXXXXXXXXXXXXXXXXXXXXXX
XXXX29B94XXXXXXXXXXXXXXXXXXXXXXX
XXXX29B94XXXXXXXXXXXXXXXXXXXXXXX




