EEEEEEEEEEEEESEEFEEEESEEFEEEESEE
EXXXXXXXXEEEESEEFEEEESEEFEEEESEE
EEEEEEEEEEEEESEEFEEXXSEEFEEEESEE
EEEEEEEEEEEESEEFEEXESEEFEEEESEEE
EEEEEEEEEEEESEEFEEEESEEFEEEESEEE
FEEEEEEEFEEEESEEFEEEESEEFEEEESEE
FESEFSFEFEEEESEEFEEEESEEFEEEESEE
EFEFEEEEFEEEESEEFEEEESEEFEEEESEE
FEEEEEEEFEEEESEEFEEEESEEFEEEESEE
FESEFSFEFEEEESEEFEEEESEEFEEEESEE
EFEFEEEEFEEEESEEFEEEESEEFEEEESEE
FEEEEEEEFEEEESEEFEEEESEEFEEEESEE
FESEFSFEFEEEESEEFEEEESEEFEEEESEE
EFEFEEEEFEEEESEEFEEEESEEFEEEESEE
FEEEEEEEFEEEESEEFEEEESEEFEEEESEE
FESEFSFEFEEEESEEFEEEESEEFEEEESEE
EFEFEEEEFEEEESEEFEEEESEEFEEEESEE
FEEEEEEEFEEEESEEFEEEESEEFEEEESEE
FESEFSFEFEEEESEEFEEEESEEFEEEESEE
EFEFEEEEFEEEESEEFEEEESEEFEEEESEE
FEEEEEEEFEEEESEEFEEEESEEFEEEESEE
FESEFSFEFEEEESEEFEEEESEEFEEEESEE
EFEFEEEEFEEEESEEFEEEESEEFEEEESEE
FEEEEEEEFEEEESEEFEEEESEEFEEEESEE
FESEFSFEFEEEESEEFEEEESEEFEEEESEE
EFEFEEEEFEEEESEEFEEEESEEFEEEESEE
FEEEEEEEFEEEESEEFEEEESEEFEEEESEE
FESEFSFEFEEEESEEFEEEESEEFEEEESEE
EFEFEEEEFEEEESEEFEEEESEEFEEEESEE
FEEEEEEEFEEEESEEFEEEESEEFEEEESEE
FESEFSFEFEEEESEEFEEEESEEFEEEESEE
EFEFEEEEFEEEESEEFEEEESEEFEEEESEE