XXXX29B94EEEEEEEEEEEEEEEEEEEEEEE
XXXX29B94EEEEEEEEEEEEEEEEEEEEEEE
XXXX29B94EEEEEEEEEEEEEEEEEEEEEEE
XXXX29BS4EEEEEEEEEEEEEEEEEEEEEEE
333389B94EEEEEEEEEEEEEEEEEEEEEEE
9S9999B94EEEEEEEEEEEEEEEEEEEEEEE
AAAAAAB94EEEEEEEEEEEEEEEEEEEEEEE
99999SB94EEEEEEEEEEEEEEEEEEEEEEE
111169B94EEEEEEEEEEEEEEEEEEEEEEE
EEEE29B94EEEEEEEEEEEEEEEEEEEEEEE
EEEE29B94EEEEEEEEEEEEEEEEEEEEEEE
EEEE29BS4EEEEEEEEEEEEEEEEEEEEEEE
EEEE29B94EEEEEEEEEEEEEEEEEEEEEEE
EEEE29B94EEEEEEEEEEEEEEEEEEEEEEE
EEEE2SB94EEEEEEEEEEEEEEEEEEEEEEE
EEEE29B94EEEEEEEEEEEEEEEEEEEEEEE
EEEE29B94EEEEEEEEEEEEEEEEEEEEEEE
EEEE29B94EEEEEEEEEEEEEEEEEEEEEEE
EEEE29B94EEEEEEEEEEEEEEEEEEEEEEE
EEEE29B94EEEEEEEEEEEEEEEEEEEEEEE
EEEE29B94EEEEEEEEEEEEEEEEEEEEEEE
EEEE29B94EEEEEEEEEEEEEEEEEEEEEEE
EEEE29B94EEEEEEEEEEEEEEEEEEEEEEE
EEEE29B94EEEEEEEEEEEEEEEEEEEEEEE
EEEE29B94EEEEEEEEEEEEEEEEEEEEEEE
EEEE29B94EEEEEEEEEEEEEEEEEEEEEEE
EEEE29B94EEEEEEEEEEEEEEEEEEEEEEE
EEEE29B94EEEEEEEEEEEEEEEEEEEEEEE
EEEE29B94EEEEEEEEEEEEEEEEEEEEEEE
EEEE29B94EEEEEEEEEEEEEEEEEEEEEEE
EEEE29B94EEEEEEEEEEEEEEEEEEEEEEE
EEEE29B94EEEEEEEEEEEEEEEEEEEEEEE



