EEEEFFFF
FFFDDEEE
FEFEFEFE
EFEFEFEF
EEEEFFFF
FFFFEEEE
FEFEFEFE
EFEFEFEF