DDDDDDDDDDDDDDDDDDDDDDDDDDDDDDDDDDDDDDDDDDDDDDDDDDDDDDDDDDDDDDDD
DDDDDDDDDDDDDDDDDDDDDDDDDDDDDDDDDDDDDDDDDDDDDDDDDDDDDDDDDDDDDDDD
DDDDDDDDDDDDDDDDDDDDDDDDDDDDDDDDDDDDDDDDDDDDDDDDDDDDDDDDDDDDDDDD
DDDDDDDDDDDDDDDDDDDDDDDDDDDDDDDDDDDDDDDDDDDDDDDDDDDDDDDDDDDDDDDD
DDDDDDDDDDDDDDDDDDDDDDDDDDDDDDDDDDDDDDDDDDDDDDDDDDDDDDDDDDDDDDDD
DDDDDDDDDDDDDDDDDDDDDDDDDDDDDDDDDDDDDDDDDDDDDDDDDDDDDDDDDDDDDDDD
DDDDDDDDDDDDDDDDDDDDDDDDDDDDDDDDDDDDDDDDDDDDDDDDDDDDDDDDDDDDDDDD
DDDDDDDDDDDDDDDDDDDDDDDDDDDDDDDDDDDDDDDDDDDDDDDDDDDDDDDDDDDDDDDD
DDDDDDDDDDDDDDDDDDDDDDDDDDDDDDDDDDDDDDDDDDDDDDDDDDDDDDDDDDDDDDDD
DDDDDDDDDFG333333333333333333333333333333333333333333HIDDDDDDDDD
DDDDDDDDDJK999C99999999999999999999999999C99999999999LMDDDDDDDDD
DDDDDDDDD19900C00000000999000000999000000C0999000000994DDDDDDDDD
DDDDDDDDD19A99C99999999999999999999999999C9999999999A94DDDDDDDDD
DDDDDDDDD19A951111111169A95111169A9511111169A9511169A94DDDDDDDDD
DDDDDDDDD19A94DDDDDDDD19A94DDDD19A94W|YXXX19A94W|Y19A94DDDDDDDDD
DDDDDDDDD19A94DXXXDWYD19A94DWYD19A94W|Y---19A94W|Y19A94DDDDDDDDD
DDDDDDDDD19A94D---DWYD19A94DWYD19A94W|YVVV1BBB4W|Y19A94DDDDDDDDD
DDDDDDDDD19A94DVVVDWYD19A94DWYD19A94W|YEFG89A94W|Y19A94DDDDDDDDD
DDDDDDDDD19A94DDDDDWYD19A94DWYD19A94W|YEJK99A94DDD19A94DDDDDDDDD
DDDDDDDDD19A94DXXXDDDD1BBB4DDDD19A94W|YE1999A94DDD19A94DDDDDDDDD
DDDDDDDDD19A94DVVVDDFG89A97HIDD19A94W|YE1999A94DDD19A94DDDDDDDDD
DDDDDDDDD19A94DDDDDDJK99999LMDD1BBB4W|YE1999A94DDD19A94DDDDDDDDD
DDDDDDDDD19A973333338999999973389A94W|YE1999A94DDD19A94DDDDDDDDD
DDDDDDDDD1999999999C999516999C999994W|YENO99A94DDD19A94DDDDDDDDD
DDDDDDDDD1999000000C0994E2990C009994W|YERS69A94W|Y19A94DDDDDDDDD
DDDDDDDDD1999999999C999738999C999994W|YXXX19A94W|Y19A94DDDDDDDDD
DDDDDDDDD19A951111116999999951169A94W|Y---19A94W|Y19A94DDDDDDDDD
DDDDDDDDD19A94DDDDDDNO99999PQDD19A94W|YVVV19A94W|Y19A94DDDDDDDDD
DDDDDDDDD19A94DXXXXDRS69A95TUDD19A9733333389A9733389A94DDDDDDDDD
DDDDDDDDD19A94D----DDD1BBB4DDDD1999999999C9999999999994DDDDDDDDD
DDDDDDDDD19A94DVVVVDDD19A94DWYD1999000000C0999000009994DDDDDDDDD
DDDDDDDDD19A94DDDDDDDD19A94DWYD1999999999C9999999999994DDDDDDDDD
DDDDDDDDD19A94DW|YDWYD19A94DWYD19A951111111111111169A94DDDDDDDDD
DDDDDDDDD19A94DW|YDWYD19A94DWYD19A94DDDDEEEEEEDDDD1BBB4DDDDDDDDD
DDDDDDDDD19A94DW|YDWYD19A94DWYD19A94DXXXEEEEEEXXXD19A94DDDDDDDDD
DDDDDDDDD19A94DW|YDWYD19A94DWYD19A94D---EEEEEE---D19A94DDDDDDDDD
DDDDDDDDD19A94DDDDDEEE19A94DDDD1BBB4DVVVEEEEEEVVVD19A94DDDDDDDDD
DDDDDDDDD19A94DXXXXEEE19A97333389A94DDDDEEEEEEDDDD19A94DDDDDDDDD
DDDDDDDDD19A94DXXXXEEE19999C99999994DXXXEEEEEEXXXD19A94DDDDDDDDD
DDDDDDDDD19A94DVVVVEEE19990C00009994D---EEEEEE---D19A94DDDDDDDDD
DDDDDDDDD19A94DVVVVEEE19999C99999994DVVVEEEEEEVVVD19A94DDDDDDDDD
DDDDDDDDD1BBB4DDDDDEEE19A95111169A94DDDDEEEEEEDDDD19A94DDDDDDDDD
DDDDDDDDD19A973333333389A94XXXX19A94DXXXEEEEEEXXXD19A94DDDDDDDDD
DDDDDDDDD1999999999C9999A94XXXX19A94D---EEEEEE---D19A94DDDDDDDDD
DDDDDDDDD1999000000C0000994XXXX19A94DVVVEEEEEEVVVD19A94DDDDDDDDD
DDDDDDDDD1999999999C99999PQXXXX19A94DDDDEEEEEEDDDD19A94DDDDDDDDD
DDDDDDDDD19A9511111111111TUDDDD19A94DXXXEEEEEEXXXD19A94DDDDDDDDD
DDDDDDDDD1BBB4XXXXXDXXXXXDXXXXX19A94D---EEEEEE---D19A94DDDDDDDDD
DDDDDDDDD19A94-----D-----D-----19A94DVVVEEEEEEVVVD19A94DDDDDDDDD
DDDDDDDDD19A94VVVVVDVVVVVDVVVVV19A94DDDDEEEEEEDDDD19A94DDDDDDDDD
DDDDDDDDD19A973333333333333333389A973333333333333389A94DDDDDDDDD
DDDDDDDDD19A999999999999999999C9999999999999C9999999A94DDDDDDDDD
DDDDDDDDD199000000000000000000C0999000000000C0000000994DDDDDDDDD
DDDDDDDDDNO9999999999999999999C9999999999999C99999999PQDDDDDDDDD
DDDDDDDDDRS111111111111111111111111111111111111111111TUDDDDDDDDD
DDDDDDDDDDDDDDDDDDDDDDDDDDDDDDDDDDDDDDDDDDDDDDDDDDDDDDDDDDDDDDDD
DDDDDDDDDDDDDDDDDDDDDDDDDDDDDDDDDDDDDDDDDDDDDDDDDDDDDDDDDDDDDDDD
DDDDDDDDDDDDDDDDDDDDDDDDDDDDDDDDDDDDDDDDDDDDDDDDDDDDDDDDDDDDDDDD
DDDDDDDDDDDDDDDDDDDDDDDDDDDDDDDDDDDDDDDDDDDDDDDDDDDDDDDDDDDDDDDD
DDDDDDDDDDDDDDDDDDDDDDDDDDDDDDDDDDDDDDDDDDDDDDDDDDDDDDDDDDDDDDDD
DDDDDDDDDDDDDDDDDDDDDDDDDDDDDDDDDDDDDDDDDDDDDDDDDDDDDDDDDDDDDDDD
DDDDDDDDDDDDDDDDDDDDDDDDDDDDDDDDDDDDDDDDDDDDDDDDDDDDDDDDDDDDDDDD
DDDDDDDDDDDDDDDDDDDDDDDDDDDDDDDDDDDDDDDDDDDDDDDDDDDDDDDDDDDDDDDD
DDDDDDDDDDDDDDDDDDDDDDDDDDDDDDDDDDDDDDDDDDDDDDDDDDDDDDDDDDDDDDDD
