EEEE29B94EEEEEEEEEEEEEEEEEEEEEEE
EEEE29B9733333333333333333333333
EEEE29BS999999999999999999999999
EEEE29BAAAAAAAAAAAAAAAAAAAAAAAAA
EEEE29B999999S9999999B999S999999
EEEE2SB95111111111169B9511111111
333389B94EEEEE42EEE29B94EEEEEEEE
9S9999B94EEEEE42EEE29B94EEEEEEEE
AAAAAAB94EEEEE42EEE29B94EEEEEEEE
99999SB94EEEEE42EEE29B94EEEEEEEE
111169B94EEEEE42EEE29B94EEEEEEEE
EEEE29B94EEEEE42EEE29B94EEEEEEEE
EEEE29B97333333333389B9733333333
EEEE29BS9999999999999B9999999999
EEEE29BAAAAAAAAAAAAAAAAAAAAAAAAA
EEEE29B999999S99999999999S999999
EEEE2SB95111111111169B9511111111
333389B94EEEEEEEEEE29B94EEEEEEEE
9S9999B94EEEEEEEEEE29B94EEEEEEEE
AAAAAAB94111111111129B94EEEEEEEE
99999SB94333333333329B94EEEEEEEE
111169B94EEEEEEEEEE29B94EEEEEEEE
EEEE29B94EEEEEEEEEE29B94EEEEEEEE
EEEE29B97333333333389B9733333333
EEEE29BS9999999999999B9999999999
EEEE29BAAAAAAAAAAAAAAAAAAAAAAAAA
EEEE29B999999S99999999999S999999
EEEE2SB9511111111111111111111111
EEEE29B94EEEEEEEEEEEEEEEEEEEEEEE
EEEE29B94EEEEEEEEEEEEEEEEEEEEEEE
EEEE29B94EEEEEEEEEEEEEEEEEEEEEEE
EEEE29B94EEEEEEEEEEEEEEEEEEEEEEE




